-gNIrxdTJE4	flying things over water	planes flying in army	journey (and next generation) of naval aviators
EzXvN2Z5BWU	random game clippings	videogame montage with music	dragon age and mass effect: 'break your heart'
omXJ6OUeT0A	smile	weird laugh in videogame	Minecraft weird smile
sgGFnV_VxVs	Asian and black dudes running on court	Filipino basketball finals?	Boys give interview after basketball regional final
UsjG3EUQdo8	pig with piglets	pig rolls in mud to cool off	pig cooling off in the mud with piglets
MEvBWYHLa4M	Blonde girl preps for Olympics	Training regime of Shawn Johnson	Training regime of Shawn Johnson
WhiXpm-7Jd8	video montage	fan-made trailer : head over heels	Head over heels : A Twilight Saga
HcVzWfF8oxk	song of a heartbroken lover?	Dj snot autotuned music	I'll get over you remixed.
5q4n4DFyIg8	Johnny Depp in a weird costume	wastin time with Willie Wonka	Charlie and the chocolate factory Fan-Video
T1DdxQeJU0s	trash game video	boy tries to grab attention	describing glitch in sumer shash bros
kn96AmhdrkI	Picker rod	Guy describes fishing rod	Picker fishing rods commercial
duLSA4CrWR8	Shifting out of old home	blonde describes mom's home state	My father's travel dairy
OxHDGjYOt3s	Testing different mattresses	Mattress Shop	Salesman explains varieties of mattresses
5qEAgaFQQ5Q	funny video	gang signs in a sticker designed by teen	trolls by Ray William Johnson
yHM6f7RRBgs	trikes flying in the sky	italian trike formation, 1994	light eagles, first italian trike formation
9yIS1ZK0xro	lego movie	lego music video	lego heist stopmotion movie
GhQ3SnZkpQo	funny fish	fish playing with ball	koi swimming and playing with ball in pond
SLdH3dD35-s	girl and her parents acting cool	girl on snow	girl ice skating while parents record
YG4JCvSFPs8	Alien bits found in garden	fake alien in garden	prop alien portrayed as dead
A_Cwy4si8wg	the best trickshotter	Shooting people with music	CoD trickshot montage
B9_GIAqltms	gameplay with music	dark legacy game server	the guild of dark legacy: star wars gameplay
aV_M7sGIXns	sad tribute	Tribute to a music star	A tribute to Gerard Way by his fans
DRBvVMNT44w	Awkward actions by man	Photon protagonist creeps out girls	Weird scene compilation from Photon
hkEFjndI0eY	Black guy has a seizure	dance fail	Black guy fails with his dance moves
CfyMcnTDAxs	christmas antics	boys dancing near Christmas tree	young boys dance-off
P6_bF90TE0Q	bird on sofa	talk with a bird	baby talk with black-capped conure
eKUOhEZRfts	Old man talks trash	warning on products	Trace Teeple mocks weird product label
CKaaJ4zmd7g	Gorillaz dance montage	Game characters do weird dance	Lineage 2 montage
OIik4uytYig	Kid rants	kids life without parents	smosh kid rants about parents
tLcw4TIgFzo	Bluetooth connection issues	Phone not connecting with device	 ebay elm327 microcontroller not connecting
VrrqaS4Jlvo	red jeep montage	red chevy gets remodelled	man fixes clear coat of Chevy
Top3WYqcf_E	rail project not getting finished	Kenyan railway project stalled	land hurdle for standard gauge railway in kenya
Jrvv6udt47Q	building phone at home	fake phone upgradation	Fake upgradation of Nokia phone in garage
p3ILnYyQDe4	man playing accordion	calliope house jig	playing calliope house using Piano Accordions
CX3ZRMFMkY4	A man talking about woodwork	16,000 woodworking projects in one place	website to help with your furniture projects
Tx10hMfRoAs	pieces of a famous painter	fan-video of paintings	Life and works of David Eustace
CQeMjNycwLM	talking trains	Lego and trains talking	Cheap remake of Thomas the Tank Engine
b4g9wrGuuGs	fighting couple	guy cheating on her girlfriend	Dude cheats with gf's grandma
dQUw7PCsMGo	remote controlled boat	RC snowboat from scratch	testing snow boat on grass
JJhJkq5ApP0	Dog wagging tail	Spaniel dog snoozing on bed	Cavalier King Charles Spanniel : tribute
3roCUFSOFk8	Guy opens box	Book review by Guy	Unboxing 'Kinesay and me', Emerald Atlas
Iodqg52UZEc	people making noise	cheerleaders dancing	 Band and cheerleaders perform on stadium chairs
m_JpKHxOk4M	creepy lady with cosmetics	lady tries makeup	eye makeup using anastasia palette
BKguNPzzie8	lady with wig	lady sings in club	local favourite Charlie Brown performs at Club 322
L1cdwbC9jfA	Music playing game	Flash flash revolution walkthrough	Brain of the moon - Flash flash revolution
UsJm8d6Ek94	cheap covering	$1 transparent wrap	cheap and affordable transparent wrap
Ftgp7zcgvpI	standing in front of wall	2 guys discussing a game	Killzone 3 developers interviewed
aLA37ZrCyOc	rollercoaster through cave and jungle	fun ride in Minecraft	Rollercoaster run in Minecraft
UUKY9Txfk7A	man playing with toys	man adds crane to toy scenery	 inspection of construction site Maxim toys
Iol5w1erKCs	Rap music for kids	Snoop Dogg with kid's poems	DJ mixes The Snowman with Still D.R.E
6rcbC7SKFBU	racing cars	may 16th car highlights	Kalamazoo speedway highlights
6rppfDaPXK4	Videogame characters shooting each other	 CoD montage	CoD: funny kills
6rQsn7gP_wI	FIFA gameplay	FIFA 13 online mode	FIFA 13 : RM vs Ireland Online
mxzsTXpje4o	Dance at wedding	Bride makes grand entrance	Bridal dance on wedding stage
JBHv3ZPq5EA	Beats unboxing	Headphones Review	DJ reviews Beats Pro
JM2vYHC8Qcg	high school baseball game	Walker Memorial High school baseball practice	Walker Memorial Chandler day baseball match, 2015
njxtQ2fNapY	homemade craft using duct tape	homemade art and craft	art and craft stuff
JMoYb76M5Dk	philosophical video	the power of positive thinking 	ways of spreading love and happiness
knUktaJmG4w	fish and grass in tank	Nano fish in aquarium	nanoecology in aquarium
0nSCp4Hcm-8	ice hockey fight	NHL player outrage	NHL: Brendan Witt, Steve Bernier, Scott Nichol, Milan Michalek slug it out
CfuLBR9zcO4	earning money the easy way	Gambling swindles	Tips and tricks to win at the roulette
aLelElHzyf4	Flying an F-14	FSX gameplay	F-14 FSX: fly-by and landing on carrier
Lc00hGIZQk8	doodles	Slackers - Gameplay	Slackers - Stick figure skates
zgKwoJiPNeo	charlie the sleepy head	animated Unicorns	Charlie and his friends :candy adventure
3ZK8UuESQRE	Fight Prownja	Miscrits gameplay 	Miscrits tourney vs Prownja
CrAkdLVhhPU	Bangalore racing	Collection of high-end bikes in Bangalore	Goldtown Bikers super thrills
5lHTOR6wPH4	Sant Claus with girls	NHL player dancing with famous troupe	Robbie Gould learning from Rockettes
2oo23bZiPLw	dancing with hats	Cowboys dancing to country music	Dance performance at Abschlussfeier, 2010
x6EwPIb7abA	Little girl playing	Child prodigy showing skills	8 yr old shows rad basketball skills
1zn7AqxNLnw	Doll fan video	Twilight with action figures	Fanmade montage of twilight with action figures
JMg0WouvNbE	bikes	superbike collection	Just a Lil Bit: Moterbike montage
tLc6ZDT2Gt4	cricket match	cicket final match highlights	XXXX Gold A Grade day 3 and final match highlights
p3471UKoXzg	banks proclaim disaster	News report on vanishing trillions	Stossel requesting oversight on people's money
al4DynnilLE	Denied	Funny sports compilation.	2014 : humorous sports review
h2TlWNmEu3s	car GPS 	TomTom GPS demo	RadarWarner demo on TomTom XXL
QhVNJ4OA3mI	Poor eye consultations	OERML on news	BBC exposes truth behind optical Express
kULt_gZ0DkM	kid on skates	Young talent shows skateboard moves	8 yr Cooper Qua's rad moves, 2013
mxsWIO-x89E	unemployed rappers	Filipino group raps	A tribute to Tyler: Green Tides 
lvzO9T0BnXE	truck can't swim	truck hauls itself to safety	Driver saves himself and truck from sinking.
9A-LAqnd6-0	fishing	fishing with the gulls	Fishing albacore in the Gulf of Mexico
hTSqrGho0K4	fish oral checkup	Catching and tossing back fish	Catching and tossing fish in shallow water
tP9rlbPaIk0	blurry videogame	Laundry rant in videogame	RoBLox : laundromat funtage in Wal-Mart
rc-kw0CAcWE	pool game	Snooker player quits midgame	Ronnie O'Sullivan drops games due to mishits
EDq77l9hsA0	singing nannies	choir singing carol	"I am determined to hold out to the end" by choir
tPUvFnKyhGg	singing penguins	Beat it' by videogame characters	Club Penguin members perform Beat It by Fall Out Boy
vppGC_xuAmE	guitar strokes	Dude strumming the guitar	Benighted-Icon : guitar cover
McQuYVUMyaw	pretty decorations	fruit decoration at a wedding/function	Dessert Arrangement by Dushan Caterers
pT8pXwIhfkY	bunch of dudes running after a ball	Italian football montage	Week 32 roundup, Serie A, 2008
oJXpVm7XTM8	Trip to Hawaii	getting travel ready	Road to Kaua'i, day1
L11cvchmEtI	running like a mad man 	MMORPG spoiler	Mabinogi: Goddess in Danger Easter egg
A0e1bOLJClw	blonde using mixer	a great drink to start your day	Healthy smoothie with whey, Mango and chocolate
MnahLuV2AlY	funny dance	Band performs on athletic track	Cedar Grove homecoming performance, 2013
rrkzsoG0cDg	cute bird roaming about	singing bird	Budgie's day tracked by GoPro
vpaWF1u7Pmc	playing with psp	put on screen saver	step by step guide to putting screen saver on PSP
nnXJ_jOR1RQ	Asian in field	Running tractor on paddy field	Rotary tiller mounted tractor rundown
G3I_JPzA3vM	FPS gameplay	COD: multiplayer	CoD Black ops 2 multiplayer highlights
juh563wb_XA	red dancers	chearleader perform on mixes	CLEAR dance performance at Fort open field, 2008
mEo-iUQZFoY	firing rounds in air	CoD: music with bullets	CoD BO2 gun sync with Zedd's Clarity
rrLMm3cp_Gw	unboxing	cheap Samsung smartphone	Samsung Mini S5 unboxing
UsM87AZ6g2M	tractor on airport	Tractor mowing grass near airport	JCB Fastrac: upgrading farm tractor
Mi5AJDAHFvU	playing with instrument	uitar lesson	Where did you sleep last night opening guitar riffs
6rIwCuCB-nc	people singing together	band singing Sweet baby	Cookie and the Monsters band cover Sweet Baby
Mntb9WnN8qs	Football match	Almeria vs RM	Kaka dazzles vs Almeria, La Liga, 2010
j5N9HMv-EtE	dog the detector	dogs undergoing training	Dogs trained to sniff bed bugs at Falco K9 Academy
Cw4lH1e8Wus	trailer	luxurious mini van	inside view of the 1995 Fleetwood Southwind
37_YOjPIlvI	kung fu fighting	Martial arts stunts	Chen style Taiji Expert demonstrating poses.
YGM4n6nJ9RQ	Shark on ship	Skylander gameplay	Toy and videogame review of Skylanders' character Thumpback
1-GsxNAlZ3c	Blond idiot kisses girls	Serial kisser strikes again	Kissing Trick' prankster performs live on news
lLQTbfP3Ou8	boat in rough waters	Lobster hunting	Gathering lobster pots in trawler
MEAZ9bJEP_o	Ugly green insect shouting	DBZ mashup	Trunks and 18 fight imperfect cell while Lady Gaga sings in background
z3QO5COQ36Q	god video	God of War gameplay	GoW 2 Battle with Ares music.
agtEyEOK6B0	horse and lady	Brown horse in stable	describing a horse bridle and its components
hkQ5nF18sd4	dance	Exercising with dance	Zumba on Smash the Club by Official Kardinal
CXdv356nUvk	minecraft	regigigas sprite Minecraft	Sprite of Regigigas, Legendary pokemon, made in minecraft
JMeIrJUCDaE	cricketer moments	Shaun Pollock wickets	Shaun Pollock vs Australia and Sri Lanka, 2003
4BYdN_vCoIo	Sweet game 	Candy crush gameplay	Candy Crush Saga, Lvl 548 walkthrough, no boosters
YAJbgUw1NKo	paper toy	Paper craftwork	Basic 3D origami techniques for beginners
kVROf1SoCDY	gossip girls 	fashion talk	vanessa marano explaining fashion VV function
ZuNBuHoSpas	toy review	toy gun firing	Kamen rider review by kid
VbzzVWVgBmI	dance	Dancing on wooden stage	An old, black couple doing Zydeco dance
nnnv05Vwfa8	toy trains	Thomas track with speed booster	Thomas gets a boost from a new jet engine.
VfQkfmktg7E	first day of operation	trains on platforms	6th april 1992, the day when manchester metrolink started
h2ZybZ5gGS0	rude ukulele	Rude': guitar cover	Ukelele and guitar cover for Rude - Magic
kImlueQiSQs	house photos	apartment ad	The Attribute': condo advertisement
z_QYuffK8Iw	snow everywhere	skiing tricks	Freestyle skiing, 2010
TokTQhx2lM8	Wildfire ride footage	roller coaster at Silver Dollar City?	Wildfire ride at Silver Dollar City Park, Missouri
YVfIbKHvFkA	old people in lab	computer classes for elderly	Volunteers help elderly get familiar with computers in Singapore
uyQA7FVPeHY	makeup 	Eyelash tutorial 	tutorial on coloring and extending eyelashes 
PGToYf7r4ps	dancing cows	cows on the dance floor	The Chick-fil-A of Greer Cows dancing to Disco Inferno at Tunes on Trade in Greer
kVjIC660Bbg	idiot boy fighting giant insect	Green insects throttling people	Gohan goes SSJ2 vs Cell
nc1I5Q9rQVY	dusky people doing makeup 	makeup tutorial	eye makeup using Reflection pallette from cared hour collection
X31Y-_VyRWM	plane on highway	Fighter pilot inspection	How fighter planes operate: from takeoff to landing, F-14,15
tLnxRt_yAy0	In the middle of nowhere	sailing in a yacht alone	Sailing the 2-wheel Beneteau Oceanis 45 alone
YYvPY4cCD3c	Black dudes in aviators	Funeral speech in front of cameras	Michael Jackson funeral speech by family
-HxucfiYwzE	make green monster in game	DC Hulk crossover	The Incredible Hulk ripoff in DC Universe Online
2ohH-prls6I	People throwing stuff in river	canoe marathon	2008 Ausable River Canoe marathon starting
ds_QGYfP1Lc	Milky Way about to die	Galaxies set to clash	Milky way and Andromeda galaxies to clash in the next 50k light years!
_kF6jD6t8Zs	Old uncle interview	Hartlepool verdict by opposition manager	Retired managerJohn Still gives verdict on Luton Town's win 2-1 over Hartlepool
Bgwnf0uCXSo	inside BMW	Gran Turismo: BMW	BMW Series 5, Gran Tourismo : An overview
P6oO5jzsOBU	Weird interview	NHL player gives shocking interview	Sidney Crosby gives vague interview
xxp6pHPkDjs	Plants videogame	Robot eaten by plants	Otto Matic, Level 7 - Pitcher plant boss battle
duZE5p3Wa5U	Videogame trailer	Deus Ex: trailer	Deus ex Human Revolution - Launch trailer
z_0J0JVc1Mc	Empty House	Luxury modern housing	A room-by-room description of a luxury apartment
vmWPxGz6jyI	Black dude in chair	Dancing with props	Naughty Boy twerking to Up and Down
jkBmncxJjcc	College swimmers	Swimming in university pool	Wingate University swimmers demonstration
SUtbs6dK-G4	Champions Tour of Monaco	behind the scenes: Monaco champions	Monaco F1 GP - Behind the scenes VIP pass
Q1Kd4uopolg	game controller	PS3 controller setup	Gioteck demonstrate their personalized PS3 controller
UUF9c8oXk08	old guy on brown chair talking	Hayao Miyazaki Interview	Hayao Miyazaki discusses the future of animation in films
YVosw7OgOJw	cartoon character jumping about	Megaman gameplay	Megaman intro completed at x5 speed.
aVuh1EhTDSo	black dude talking	Morgan Freeman interview	The Dark Knight Rises: Morgan Freeman exclusively interviewed
